11111111111111111111111111111111
1E0000000C00000C0000000000000001
10100101001000001010010000000101
101001C0101010100010010000000101
1P0000000C000000C000000000000001
11111111111111111111111111111111